#####################
#       #       # # #
# ### ### ##### # # #
# #       #   #     #
### # ####### # #####
#   # #   #         #
# ### ### # # ##### #
# #   #     #     # #
### ### ### ##### # #
#   #   #       # # #
# ### # ########### #
#     #     #       #
# # ##### ##### ### #
# #   # #   # # # # #
####### ### # # # # #
#   #     # #   #   #
# ### # ### ### # ###
#     #   #   # #   #
# ### ### # # #### ##
# #     #   #       #
#####################