#####################
# #     #           #
# # # ### ##### # ###
# # #     # #   #   #
# ##### ### # ### ###
#   # #   #   #     #
### # # # ###########
#       #   #   #   #
# ### # ### # # # # #
# #   #   #   #   # #
#####################