####################################################################################
#       #       # # ##       #       # # ##       #       # # ##       #       # # #
# ### ### ##### # # ## ### ### ##### # # ###### ### ##### # # ## ### ### ##### # # #
# #       #   #     ## #       #   #        #       #   #     ## #       #   #     #
### # ####### # ######## # ####### # ######## # ####### # ######## # ####### # #####
#   # #   #         ##   # #   #              # #   #         #    # #   #         #  
# ### ### # # ##### ###### ### # # ##### ## ### ### # # ##### ## ### ### # # ##### #
# #   #     #     #    #   #     #     # ## #   #     #     # ## #   #     #     ###
### ### ### ##### # #### ### ### ##### ###### ### ### ##### # #### ### ### ##### # #
#   #   #       # # ##   #   #       # # ##   #   #       # # ##   #   #       # # #
# ### # ########### ## ### # ## ######## ## ### # ######### # ## ### # ########### #
#     #     #       ##     #     #              #     #        #     #     #       #
# # ##### ##### ### ## # ##### ##### ### ## # ##### ##### ### ## # ##### ##### ### #
# #   # #   # # # # ## #   # #   # # # # ## #   # #   # # # # ## #   # #   # # # # #
####### ### # # # # ######## ### # # # # ######## ### # # # # ######## ### # # # # #
#   #     # #   #        #     # #   #        #     # #   #   ##   #     # #   #   #
# ### # ### ### # #### ### # ### ### # #### ### # ### ### # #### ### # ### ### # ###
#     #   #   # #   ##     #   #   # #   ##     #   #   # #          #   #   # #   #
# ### ### # # ### #### ### ### # # ### #### ### ### # # ### #### ### ### # # ### ###
# #     # # #       ## #     #   #       ## #     #   #       ## #     #   #       #
######### ######### ##### ######### ############ ######## ###### ### ##### ### ### #
#       #       # # ##       #       # # ##       #       # # ##       #       # # #
# ### ### ##### # # ## ### ### ##### # # ## ### ### ##### # # ## ### ### ##### # # #
# #       #   #     ## #       #   #     ## #       #   #     ## #       #   #     #
### # ####### # ######## # ####### # ######## # ####### # ######## # ####### # #####
#   # #   #         ##   # #   #         ##   # #   #              # #   #         #  
# ### ### # # ##### ## ### ### # # ##### ## ### ### # # ##### ## ### ### # # ##### #
# #   #     #     # ## #   #     #     # ## #   #     #     # ## #   #     #     # #
### ### ### ##### # #### ### ### ##### # #### ### ### ##### # #### ### ### ##### # #
#   #   #       # #      #   #       # # ##   #   #       # # ##   #   #       # # #
# ### # ########### ## ### # ########### ## ### # ########### ## ### # ########### #
#     #     #       ##     #     #       ##     #     #              #     #       #
# # ##### ##### ### ## # ##### ##### ### ## # ##### ##### ### ## # ##### ##### ### #
# #   # #   # # # # ## #   # #   # # # # #  #   # #   # # # # ## #   # #   # # # # #
####### ### # # # # ######## ### # # # # ######## ### # # # # ######## ### # # # # #
#   #     # #   #   #    #     # #   #        #     # #   #   ##   #     # #   #   #
# ### # ### ### # #### ### # ### ### # #### ### # ### ### # #### ### # ### ### # ###
#     #   #   # #   ##     #   #   # #   ##     #   #   # #   ##     #   #   # #   #
# ### ### # # ### #### ### ### # # ######## ### ### # # ### #### ### ### # # ### ###
# #     #   #       ## #     #   #       ## #     #   #       ## #     #   #       #
# ############### ################## ######################## #### ####### #########
# ############### ################## ######################## #### ####### #########
#       #       # # ##       #       # # ##       #       # # ##       #       # # #
# ### ### ##### # # ## ### ### ##### # # ###### ### ##### # # ## ### ### ##### # # #
# #       #   #     ## #       #   #        #       #   #     ## #       #   #     #
### # ####### # ######## # ####### # ######## # ####### # ######## # ####### # #####
#   # #   #         ##   # #   #              # #   #         #    # #   #         #  
# ### ### # # ##### ###### ### # # ##### ## ### ### # # ##### ## ### ### # # ##### #
# #   #     #     #    #   #     #     # ## #   #     #     # ## #   #     #     ###
### ### ### ##### # #### ### ### ##### ###### ### ### ##### # #### ### ### ##### # #
#   #   #       # # ##   #   #       # # ##   #   #       # # ##   #   #       # # #
# ### # ########### ## ### # ## ######## ## ### # ######### # ## ### # ########### #
#     #     #       ##     #     #              #     #        #     #     #       #
# # ##### ##### ### ## # ##### ##### ### ## # ##### ##### ### ## # ##### ##### ### #
# #   # #   # # # # ## #   # #   # # # # ## #   # #   # # # # ## #   # #   # # # # #
####### ### # # # # ######## ### # # # # ######## ### # # # # ######## ### # # # # #
#   #     # #   #        #     # #   #        #     # #   #   ##   #     # #   #   #
# ### # ### ### # #### ### # ### ### # #### ### # ### ### # #### ### # ### ### # ###
#     #   #   # #          #   #   # #   ##     #   #   # #          #   #   # #   #
# ### ### # # ### #### ### ### # # ### #### ### ### # # ### #### ### ### # # ### ###
# #     # # #       ## #     #   #       ## #     #   #       ## #     #   #       #
######### ######### ##### ######### ############ ######## ###### ### ##### ### ### #
#       #       # # ##       #       # # ##       #       # #          #       # # #
# ### ### ##### # # ## ### ### ##### # # ## ### ### ##### # # ## ### ### ##### # # #
# #       #   #     ## #       #   #     ## #       #   #     ## #       #   #     #
### # ####### # ######## # ####### # ######## # ####### # ######## # ####### # #####
#   # #   #         ##   # #   #         ##   # #   #              # #   #         #  
# ### ### # # ##### ## ### ### # # ##### ## ### ### # # ##### ## ### ### # # ##### #
# #   #     #     # ## #   #     #     # ## #   #     #     # ## #   #     #     # #
### ### ### ##### # #### ### ### ##### # #### ### ### ##### # #### ### ### ##### # #
#   #   #       # #      #   #       # # ##   #   #       # # ##   #   #       # # #
# ### # ########### ## ### # ########### ## ### # ########### ## ### # ########### #
#     #     #       ##     #     #       ##     #     #              #     #       #
# # ##### ##### ### ## # ##### ##### ### ## # ##### ##### ### ## # ##### ##### ### #
# #   # #   # # # # ## #   # #   # # # # #  #   # #   # # # # ## #   # #   # # # # #
####### ### # # # # ######## ### # # # # ######## ### # # # # ######## ### # # # # #
#   #     # #   #        #     # #   #        #     # #   #        #     # #   #   #
# ### # ### ### # #### ### # ### ### # #### ### # ### ### # #### ### # ### ### # ###
#     #   #   # #   ##     #   #   # #   ##     #   #   # #   ##     #   #   # #   #
# ### ### # # ### #### ### ### # # ######## ### ### # # ### #### ### ### # # ### ###
# #     #   #       ## #     #   #       ## #     #   #       ## #     #   #       #
####################################################################################