##########
#   #    #
# #   ## #
#  #######
#####   ##
#   ### ##
# #   #  #
### # ## #
#   #    #
##########